################################################################################################
################################################################################################
################################################################################################
################################################################################################
####........................................................................................####
####........................................................................................####
####........................................................................................####
####........................................................................................####
####........................................................................................####
####........................................................................................####
####........................................................................................####
####........................................................................................####
####........................................................................................####
####........................................................................................####
####........................................................................................####
####........................................................................................####
####........................................................................................####
####........................................................................................####
............................................................................................####
............................................................................................####
............................................................................................####
............................................................................................####
............................................................................................####
............................................................................................####
............................................................................................####
............................................................................................####
............................................................................................####
............................................................................................####
............................................................................................####
............................................................................................####
............................................................................................####
............................................................................................####
............................................................................................####
............................................................................................####
............................................................................................####
............................................................................................####
............................................................................................####
............................................................................................####
####........................................................................................####
####........................................................................................####
####........................................................................................####
####........................................................................................####
####........................................................................................####
####........................................................................................####
####........................................................................................####
####........................................................................................####
####........................................................................................####
####........................................................................................####
####........................................................................................####
####........................................................................................####
#######################################......................###################################
#######################################......................###################################
#######################################......................###################################
#######################################......................###################################