######################################......................####################################
######################################......................####################################
######################################......................####################################
######################################......................####################################
####........................................................................................####
####........................................................................................####
####........................................................................................####
####........................................................................................####
####........................................................................................####
####........................................................................................####
####...GGGGG................................................................................####
####...GGGGG................................................................................####
####...GGGGG................................................................................####
####...GGGGG................................................................................####
####...GGGGG................................................................................####
####........................................................................................####
####........................................................................................####
####........................................................................................####
####........................................................................................####
####........................................................................................####
####........................................................................................####
####........................................................................................####
####........................................................................................####
####........................................................................................####
####........................................................................................####
####........................................................................................####
####........................................................................................####
####........................................................................................####
####........................................................................................####
####........................................................................................####
####........................................................................................####
####........................................................................................####
####........................................................................................####
####........................................................................................####
####........................................................................................####
####........................................................................................####
####........................................................................................####
####........................................................................................####
####........................................................................................####
####........................................................................................####
####........................................................................................####
####........................................................................................####
####........................................................................................####
####........................................................................................####
####........................................................................................####
####........................................................................................####
####........................................................................................####
####........................................................................................####
####........................................................................................####
####........................................................................................####
######################################......................####################################
######################################......................####################################
######################################......................####################################
######################################......................####################################