#####################################......................#####################################
#####################################......................#####################################
#####################################......................#####################################
#####################################......................#####################################
####........................................................................................####
####........................................................................................####
####........................................................................................####
####........................................................................................####
####........................................................................................####
####........................................................................................####
####........................................................................................####
####........................................................................................####
####........................................................................................####
####........................................................................................####
####........................................................................................####
####........................................................................................####
................................................................................................
................................................................................................
................................................................................................
................................................................................................
................................................................................................
................................................................................................
................................................................................................
................................................................................................
................................................................................................
................................................................................................
................................................................................................
................................................................................................
................................................................................................
................................................................................................
................................................................................................
................................................................................................
................................................................................................
................................................................................................
................................................................................................
................................................................................................
................................................................................................
................................................................................................
####........................................................................................####
####........................................................................................####
####........................................................................................####
####........................................................................................####
####........................................................................................####
####........................................................................................####
####........................................................................................####
####........................................................................................####
####........................................................................................####
####........................................................................................####
####........................................................................................####
####........................................................................................####
#####################################......................#####################################
#####################################......................#####################################
#####################################......................#####################################
#####################################......................#####################################