################################################################################################
################################################################################################
################################################################################################
################################################################################################
####........................................................................................####
####........................................................................................####
####........................................................................................####
####........................................................................................####
####........................................................................................####
####........................................................................................####
####........................................................................................####
####........................................................................................####
####........................................................................................####
####........................................................................................####
####........................................................................................####
####........................................................................................####
####............................................................................................
####............................................................................................
####............................................................................................
####............................................................................................
####............................................................................................
####............................................................................................
####............................................................................................
####............................................................................................
####............................................................................................
####............................................................................................
####............................................................................................
####............................................................................................
####............................................................................................
####............................................................................................
####............................................................................................
####............................................................................................
####............................................................................................
####............................................................................................
####............................................................................................
####............................................................................................
####............................................................................................
####............................................................................................
####........................................................................................####
####........................................................................................####
####........................................................................................####
####........................................................................................####
####........................................................................................####
####........................................................................................####
####........................................................................................####
####........................................................................................####
####........................................................................................####
####........................................................................................####
####........................................................................................####
####........................................................................................####
#####################################......................#####################################
#####################################......................#####################################
#####################################......................#####################################
#####################################......................#####################################