################################################################################################
################################################################################################
################################################################################################
################################################################################################
####........................................................................................####
####........................................................................................####
####........................................................................................####
####........................................................................................####
####........................................................................................####
####........................................................................................####
####........................................................................................####
####........................................................................................####
####........................................................................................####
####........................................................................................####
####........................................................................................####
####........................................................................................####
####............................................................................................
####............................................................................................
####............................................................................................
####............................................................................................
####............................................................................................
####............................................................................................
####............................................................................................
####............................................................................................
####............................................................................................
####............................................................................................
####............................................................................................
####............................................................................................
####............................................................................................
####............................................................................................
####............................................................................................
####............................................................................................
####............................................................................................
####............................................................................................
####............................................................................................
####............................................................................................
####............................................................................................
####............................................................................................
####........................................................................................####
####........................................................................................####
####........................................................................................####
####........................................................................................####
####........................................................................................####
####........................................................................................####
####........................................................................................####
####........................................................................................####
####........................................................................................####
####........................................................................................####
####........................................................................................####
####........................................................................................####
################################################################################################
################################################################################################
################################################################################################
################################################################################################