################################################################################################
#..............................................................................................#
#..............................................................................................#
#..............................................................................................#
#...............................................##.............................................#
#...............................................##.............................................#
#..............................................####............................................#
#.............................................######...........................................#
#.....................................##......######......##...................................#
#.....................................##.....########.....##...................................#
#....................................####...##########...####..................................#
#....................................####.##############.####..................................#
#....................................########################..................................#
#....................................##########....##########..................................#
#....................................########........########..................................#
#....................................########........########..................................#
#....................................#######..........#######..................................#
#....................................#######..........#######..................................#
#....................................######...........#######..................................#
#....................................######............######..................................#
#....................................######............######..................................#
#....................................######............######..................................#
#....................................######............######..................................#
#....................................######............######..................................#
#..............................................................................................#
#..............................................................................................#
#..............................................................................................#
#..............................................................................................#
#..............................................................................................#
#..............................................................................................#
#..............................................................................................#
#..............................................................................................#
#..............................................................................................#
#..............................................................................................#
#..............................................................................................#
#..............................................................................................#
#..............................................................................................#
#..............................................................................................#
#..............................................................................................#
#..............................................................................................#
#..............................................................................................#
#..............................................................................................#
#..............................................................................................#
#..............................................................................................#
#..............................................................................................#
#..............................................................................................#
#..............................................................................................#
#..............................................................................................#
#..............................................................................................#
#..............................................................................................#
#..............................................................................................#
#..............................................................................................#
#..............................................................................................#
#######################################.....................####################################