################################################################################################
################################################################################################
################################################################################################
################################################################################################
####........................................................................................####
####........................................................................................####
####........................................................................................####
####........................................................................................####
####........................................................................................####
####........................................................................................####
####........................................................................................####
####........................................................................................####
####........................................................................................####
####........................................................................................####
####........................................................................................####
####........................................................................................####
............................................................................................GGGG
............................................................................................GGGG
............................................................................................GGGG
............................................................................................GGGG
............................................................................................GGGG
............................................................................................GGGG
............................................................................................GGGG
............................................................................................GGGG
............................................................................................GGGG
............................................................................................GGGG
............................................................................................GGGG
............................................................................................GGGG
............................................................................................GGGG
............................................................................................GGGG
............................................................................................GGGG
............................................................................................GGGG
............................................................................................GGGG
............................................................................................GGGG
............................................................................................GGGG
............................................................................................GGGG
............................................................................................GGGG
............................................................................................GGGG
............................................................................................####
............................................................................................####
####........................................................................................####
####........................................................................................####
####........................................................................................####
####........................................................................................####
####........................................................................................####
####........................................................................................####
####........................................................................................####
####........................................................................................####
####........................................................................................####
####........................................................................................####
################################################################################################
################################################################################################
################################################################################################
################################################################################################