################################################################################################
#..............................................................................................#
#..............................................................................................#
#..............................................................................................#
#..............................................................................................#
#..............................................................................................#
#..............................................................................................#
#..............................................................................................#
#..............................................................................................#
#..............................................................................................#
#..............................................................................................#
#..............................................................................................#
#..............................................................................................#
#..............................................................................................#
#..............................................................................................#
#..............................................................................................#
#...............................................................................................
#...............................................................................................
#...............................................................................................
#...............................................................................................
#...............................................................................................
#..............................................##...............................................
#.............................................####..............................................
#..........................................##########...........................................
#.........................................####....####..........................................
#........................................#####....#####.........................................
#...................................##...#####....#####...##....................................
#...................................##..######....######..##....................................
#...................................##.#######....#######.##....................................
#...................................##.#######....#######.##....................................
#...................................##########....##########....................................
#...................................##########....##########....................................
#...................................##########....##########....................................
#...................................##########....##########....................................
#...................................##########....##########....................................
#...................................##########....##########....................................
#...................................##########....##########....................................
#...................................##########....##########....................................
#...................................##....................##....................................
#...............................................................................................
#..............................................................................................#
#..............................................................................................#
#..............................................................................................#
#..............................................................................................#
#..............................................................................................#
#..............................................................................................#
#..............................................................................................#
#..............................................................................................#
#..............................................................................................#
#..............................................................................................#
#..............................................................................................#
#..............................................................................................#
#..............................................................................................#
######################################....................######################################