################################################################################################
################################################################################################
################################################################################################
################################################################################################
####........................................................................................####
####........................................................................................####
####........................................................................................####
####........................................................................................####
####........................................................................................####
####........................................................................................####
####........................................................................................####
####........................................................................................####
####........................................................................................####
####........................................................................................####
####........................................................................................####
####........................................................................................####
............................................................................................####
............................................................................................####
............................................................................................####
............................................................................................####
............................................................................................####
............................................................................................####
............................................................................................####
............................................................................................####
............................................................................................####
............................................................................................####
............................................................................................####
............................................................................................####
............................................................................................####
............................................................................................####
............................................................................................####
............................................................................................####
............................................................................................####
............................................................................................####
............................................................................................####
............................................................................................####
............................................................................................####
............................................................................................####
####........................................................................................####
####........................................................................................####
####........................................................................................####
####........................................................................................####
####........................................................................................####
####........................................................................................####
####........................................................................................####
####........................................................................................####
####........................................................................................####
####........................................................................................####
####........................................................................................####
####........................................................................................####
######################################......................####################################
######################################......................####################################
######################################......................####################################
######################################......................####################################