################################################################################################
#..............................................................................................#
#..............................................................................................#
#..............................................................................................#
#..............................................................................................#
#..............................................................................................#
#..............................................................................................#
#..............................................................................................#
#..............................................................................................#
#..............................................................................................#
#..............................................................................................#
#..............................................................................................#
#..............................................................................................#
#..............................................................................................#
#..............................................................................................#
#..............................................................................................#
#..............................................................................................#
#..............................................................................................#
#..............................................................................................#
#..............................................................................................#
#..............................................................................................#
#..............................................................................................#
#..............................................................................................#
#..............................................................................................#
#..............................................................................................#
#..............................................................................................#
#..............................................................................................#
#..............................................................................................#
#..............................................................................................#
#..............................................................................................#
#..............................................................................................#
#..............................................................................................#
#..............................................................................................#
#..............................................................................................#
#..............................................................................................#
#..............................................................................................#
#..............................................................................................#
#..............................................................................................#
#..............................................................................................#
#..............................................................................................#
#..............................................................................................#
#..............................................................................................#
#..............................................................................................#
#..............................................................................................#
#..............................................................................................#
#..............................................................................................#
#..............................................................................................#
#..............................................................................................#
#..............................................................................................#
#..............................................................................................#
#..............................................................................................#
#..............................................................................................#
#..............................................................................................#
###################################..........................###################################